1
5 22
A
1
4
5 20 5 19 5 18 5 17 6 16 6 15 7 14 7 13 8 12 8 11 -1 -1
-
2
4 57
N
0
3
6 59 7 59 8 59 -1 -1
4
4 55 4 54 4 53 4 52 4 51 4 50 4 49 4 48 4 47 5 46 6 45 7 44 8 43 9 42 9 41 9 40 9 39 9 38 9 37 9 36 9 35 9 34 9 33 9 32 9 31 9 30 9 29 9 28 9 27 9 26 9 25 9 24 9 23 9 22 9 21 9 20 9 19 9 18 9 17 9 16 9 15 9 14 -1 -1
-
3
10 57
A
6
2
8 59 7 59 6 59 -1 -1
4
10 55 10 54 10 53 10 52 10 51 10 50 10 49 10 48 10 47 10 46 10 45 10 44 10 43 10 42 10 41 10 40 10 39 10 38 10 37 10 36 10 35 10 34 10 33 10 32 10 31 10 30 10 29 10 28 10 27 10 26 10 25 10 24 10 23 10 22 10 21 10 20 10 19 10 18 10 17 10 16 10 15 10 14 -1 -1
-
4
10 10
B
3
1
8 11 8 12 7 13 7 14 6 15 6 16 5 17 5 18 5 19 5 20 -1 -1
3
10 14 10 15 10 16 10 17 10 18 10 19 10 20 10 21 10 22 10 23 10 24 10 25 10 26 10 27 10 28 10 29 10 30 10 31 10 32 10 33 10 34 10 35 10 36 10 37 10 38 10 39 10 40 10 41 10 42 10 43 10 44 10 45 10 46 10 47 10 48 10 49 10 50 10 51 10 52 10 53 10 54 10 55 -1 -1
2
9 14 9 15 9 16 9 17 9 18 9 19 9 20 9 21 9 22 9 23 9 24 9 25 9 26 9 27 9 28 9 29 9 30 9 31 9 32 9 33 9 34 9 35 9 36 9 37 9 38 9 39 9 40 9 41 9 42 8 43 7 44 6 45 5 46 4 47 4 48 4 49 4 50 4 51 4 52 4 53 4 54 4 55 -1 -1
-
-
################################################################################################ 
#                                                                                              #
#                                                                                              # 
#                                                       |||||                                  #
#                    |||||                     ---------| N |                                  # 
#                ----| A |                    -         |||||                                  #
#              --    |||||                   -             -                                   # 
#            --                             -              -                                   #
#          --                              -               -                                   # 
#        |||||-----------------------------             |||||                                  #
#        | B |------------------------------------------| A |                                  # 
#        |||||                                          |||||                                  #
#                                                                                              # 
#                                                                                              #
#                                                                                              # 
#                                                                                              #
#                                                                                              # 
#                                                                                              #
#                                                                                              # 
#                                                                                              #
#                                                                                              # 
#                                                                                              #
#                                                                                              # 
#                                                                                              #
#                                                                                              # 
################################################################################################
